2003_invasion_of_Iraq	Politics and economics
Affirmative_action	Politics and economics
African_National_Congress	Politics and economics
American_Civil_Liberties_Union	Politics and economics
American_Hunters_and_Shooters_Association	Politics and economics
History_of_the_Jews_in_the_United_States	Politics and economics
American_Jews	Politics and economics
Anarchism	Politics and economics
Anarcho-capitalism	Politics and economics
Anti-Americanism	Politics and economics
Anti-clericalism	Politics and economics|||Religion
Anti-Irish_racism	Politics and economics
Antisemitism	Politics and economics|||History|||People
Asian_American	Politics and economics
Atheism	Politics and economics|||Religion
Austrian_School	Politics and economics
Bashar_al-Assad	Politics and economics
Syrian_Civil_War	Politics and economics
Black_supremacy	Politics and economics
Boricua_Popular_Army	Politics and economics
British_National_Party	Politics and economics
Capitalism	Politics and economics
Capital_punishment	Politics and economics
Catalonia	Politics and economics
Cherokee	Politics and economics
China	Politics and economics|||History
Espionage	Politics and economics
Christian_right	Politics and economics|||Religion
Plame_affair	Politics and economics
Plame_affair_timeline	Politics and economics
Communism	Politics and economics|||History
Communist_state	Politics and economics
Conservatism_in_the_United_States	Politics and economics
Controversy	Politics and economics
Copyright	Politics and economics
Free_software	Politics and economics
Viral_license	Politics and economics
Copyright_infringement	Politics and economics
Digital_Millennium_Copyright_Act	Politics and economics
Copyright_Term_Extension_Act	Politics and economics
Inducing_Infringement_of_Copyrights_Act	Politics and economics
Corsica	Politics and economics
Crime_in_the_United_States	Politics and economics
Criticism_of_Walmart	Politics and economics
Cuba	Politics and economics
Culture_war	Politics and economics
Cyprus	Politics and economics
Cyprus_dispute	Politics and economics|||History
Deaf_American	Politics and economics
Ethnic_group	Politics and economics|||History
Demographics_of_Europe	Politics and economics
Demographics_of_the_United_States	Politics and economics
Domestic_violence	Politics and economics|||People
Detroit	Politics and economics
Economy_of_Japan	Politics and economics
Efforts_to_impeach_George_W._Bush	Politics and economics
European_Union	Politics and economics
Fascism	Politics and economics|||People
Federal_Deposit_Insurance_Corporation	Politics and economics
Federal_Marriage_Amendment	Politics and economics
Feminism	Politics and economics|||Religion
Fox_News_Channel	Politics and economics|||Media and culture
Fractional-reserve_banking	Politics and economics
Free_trade	Politics and economics
Resistance_movement	Politics and economics
LGBT_rights_by_country_or_territory	Politics and economics
Genocide_denial	Politics and economics
Gun_control	Politics and economics
Overview_of_gun_laws_by_nation	Politics and economics
Hamas	Politics and economics
Harry's_Place	Politics and economics
Hate_crime	Politics and economics|||Linguistics
Health_care_reform_in_the_United_States	Politics and economics
Health_Services_Union_expenses_affair	Politics and economics
Hezbollah	Politics and economics
Hispanic	Politics and economics|||History
Latino_(demonym)	Politics and economics|||History
Adolf_Hitler	Politics and economics|||People
The_Holocaust	Politics and economics|||People
Holodomor	Politics and economics
Ireland	Politics and economics|||History
Irish_people	Politics and economics
Isa_Gambar	Politics and economics
History_of_Israel	Politics and economics
Israeli-Palestinian_conflict	Politics and economics
Italian_American	Politics and economics|||People
Anti-Italianism	Politics and economics
Japan	Politics and economics|||People
Kashmir	Politics and economics
Korean_War	Politics and economics|||History
Kosovo	Politics and economics
Louisiana	Politics and economics
Chicago	Politics and economics
New_Jersey	Politics and economics|||People
Lebanon	Politics and economics
Liberalism_in_the_United_States	Politics and economics
Libertarianism	Politics and economics
Macedonia	Politics and economics
Macedonians_(ethnic_group)	Politics and economics
Moldavia	Politics and economics
Moldovans	Politics and economics
Masculism	Politics and economics
Men's_rights_movement	Politics and economics
Mexico	Politics and economics|||History
Morality	Politics and economics
Ethics	Politics and economics
Multiculturalism	Politics and economics|||Media and culture
Muslim_Brotherhood	Politics and economics
NATO	Politics and economics
National_Democratic_Party_of_Germany	Politics and economics
Bombing_of_Dresden_in_World_War_II	Politics and economics
Native_American_name_controversy	Politics and economics
National-Anarchism	Politics and economics
Nazi_Germany	Politics and economics
Gun_Control_in_the_Third_Reich_(book)	Politics and economics
Neoconservatism	Politics and economics
Neoliberalism	Politics and economics
New_World_Order_(conspiracy_theory)	Politics and economics
Politics_of_North_Korea	Politics and economics
Northern_Ireland	Politics and economics
Nullum_crimen,_nulla_poena_sine_praevia_lege_poenali	Politics and economics
Occupy_Wall_Street	Politics and economics
Occupy_movement	Politics and economics
Osama_bin_Laden	Politics and economics
Al-Qaeda	Politics and economics
Mandatory_Swedish	Politics and economics
Palestine	Politics and economics
Palestine_Liberation_Organization	Politics and economics
Park51	Politics and economics
World_Trade_Center_site	Politics and economics
Patriotism	Politics and economics
Pegida	Politics and economics
People_for_the_Ethical_Treatment_of_Animals	Politics and economics
Pioneer_Fund	Politics and economics
Poles	Politics and economics
Anti-Polish_sentiment	Politics and economics
Political_correctness	Politics and economics|||Media and culture
Political_party	Politics and economics
Partisan_(political)	Politics and economics
Poverty	Politics and economics
Price-Anderson_Nuclear_Industries_Indemnity_Act	Politics and economics
State_school	Politics and economics|||Law and order
Puerto_Ricans_in_the_United_States	Politics and economics
Quebec	Politics and economics|||Linguistics
Canada	Politics and economics
Sociology_of_race_and_ethnic_relations	Politics and economics
Racial_quota	Politics and economics
Race_(human_categorization)	Politics and economics|||Science, biology, and health
Demographics_of_Chile	Politics and economics
Racism	Politics and economics|||People
Recession	Politics and economics
Salvador_Allende	Politics and economics
Same-sex_marriage	Politics and economics|||Religion
Saskatchewan_Party	Politics and economics
Saudi_Arabia	Politics and economics
Sharia	Politics and economics|||Religion
Laura_Schlessinger	Politics and economics|||People
School_violence	Politics and economics
Mitt_Romney_dog_incident	Politics and economics
Republika_Srpska	Politics and economics
Republic_of_Serbian_Krajina	Politics and economics
Sedition	Politics and economics
Sexual_harassment	Politics and economics
Separatism	Politics and economics
September_11_attacks	Politics and economics|||History
Ariel_Sharon	Politics and economics
Silesia	Politics and economics|||History
Socialism	Politics and economics
Southeastern_United_States	Politics and economics
Southern_United_States	Politics and economics
Texas	Politics and economics
Spain	Politics and economics
Sudan	Politics and economics
South_Sudan	Politics and economics
Darfur	Politics and economics
Bank	Politics and economics
Switzerland	Politics and economics
Synarchism	Politics and economics
Syrian_Social_Nationalist_Party	Politics and economics
Tea_Party_movement	Politics and economics
Tea_Party_protests	Politics and economics
Taliban	Politics and economics
Terrorism	Politics and economics
List_of_designated_terrorist_groups	Politics and economics
Tibet	Politics and economics
Tobin_tax	Politics and economics
Torture	Politics and economics
Medical_torture	Politics and economics|||Science, biology, and health
Health_care	Politics and economics
United_Nations	Politics and economics
Patriot_Act	Politics and economics
United_States	Politics and economics
War_on_Terror	Politics and economics
Valencian_people	Politics and economics
Valencian_nationalism	Politics and economics
Catalans	Politics and economics
Catalan_nationalism	Politics and economics
Valencian	Politics and economics
Catalan_language	Politics and economics
Vector_Marketing	Politics and economics
War_on_Drugs	Politics and economics
Western_culture	Politics and economics
White_American	Politics and economics
Telephone_tapping	Politics and economics
Paul_Wolfowitz	Politics and economics
Womyn	Politics and economics
Woman	Politics and economics|||Science, biology, and health|||Sexuality|||Media and culture
Xinjiang	Politics and economics
Yugoslavia	Politics and economics
Zaire	Politics and economics
Democratic_Republic_of_the_Congo	Politics and economics
Zimbabwe	Politics and economics
2011_?hoku_earthquake_and_tsunami	History
1953_Iranian_coup_d'?tat	History
1963_South_Vietnamese_coup	History
1973_Chilean_coup_d'?tat	History
1992_Los_Angeles_riots	History
American_Airlines_Flight_77	History
American_Revolution	History
Apartheid	History
Moon_landing_conspiracy_theories	History
Armenian_Genocide	History
Aryan_invasion_theory	History
Atomic_bombings_of_Hiroshima_and_Nagasaki	History
Battle_of_Cuito_Cuanavale	History
Biafra	History
Black_Power	History
Bloody_Sunday_(1972)	History
Bosnia_and_Herzegovina	History
Bloody_Sunday_(1939)	History
Centre_Party_(Germany)	History
Chicano_nationalism	History
Mexican_American	History
Coand?-1910	History
Cold_War	History
Cuban_Missile_Crisis	History
Confederate_States_of_America	History
Jim_Crow_laws	History
Racial_segregation	History
Constitutional_law	History
Crusades	History
Normandy_landings	History
France	History
East_Germany	History|||People
Falkland_Islands	History
French_Revolution	History
Great_Purge	History
Genocide	History
Great_Depression	History
Green_Revolution	History
Heimatvertriebene	History
Great_Famine_(Ireland)	History
Irredentism	History
Italy	History
Internment_of_Japanese_Americans	History
Jesus	History
Jews	History|||Science, biology, and health
Ukraine	History
Poland	History
Assassination_of_John_F._Kennedy	History
Kurdish_genocide	History
Kuril_Islands	History
Libyan_Crisis_(2011-present)	History
Louisiana_Purchase	History
Majestic_12	History
Maoism	History
Cannabis_(drug)	History
Legality_of_cannabis	History
Mexican-American_War	History
History_of_Mexican_Americans	History
Middle_Ages	History
Native_Americans_in_the_United_States	History|||People
Nazism	History
Nordic_race	History
Aryan_race	History
White_people	History
Okinawa_Prefecture	History
Operation_Wetback	History
Other_Losses	History
Panama_Canal	History
Panama_Canal_Zone	History
Philippines	History
Piprahwa	History
Poland-Russia_relations	History
Poland-Ukraine_relations	History
Prohibition	History
Prussia	History
Puerto_Rico	History
Quebec_sovereignty_movement	History
Political_radicalism	History
Rape_during_the_occupation_of_Germany	History
Roswell_UFO_incident	History
Sanhedrin	History
Scientology	History|||Religion|||People
Slavery	History
Republics_of_the_Soviet_Union	History
Russian_Soviet_Federative_Socialist_Republic	History
Soviet_Union	History
Soviet_war_crimes	History
Spanish-American_War	History
Spanish_Civil_War	History
Spanish_Inquisition	History
Stem_cell	History|||Science, biology, and health
Texas_Revolution	History
Battle_of_the_Alamo	History
The_Rape_of_Nanking_(book)	History
Tiananmen_Square_protests_of_1989	History
Trail_of_Tears	History|||People
TWA_Flight_800	History
American_Civil_War	History|||People
War_of_1812	History
United_States_presidential_election,_2000	History
Unidentified_flying_object	History
Usta?e	History
Vietnam_War	History
Warsaw_Pact	History
Watergate_scandal	History|||People
White_supremacy	History
World_War_I	History
World_War_II	History
2012	Religion
2012_phenomenon	Religion
Mesoamerican_Long_Count_calendar	Religion
Adventism	Religion
Agnosticism	Religion
American_Family_Association	Religion
Answers_in_Genesis	Religion|||Science, biology, and health|||People
Violence_against_Muslims_in_India	Religion
Anti-Judaism	Religion
Apollo_Quiboloy	Religion
Biblical_literalism	Religion
Book_of_Enoch	Religion
Born_again_(Christianity)	Religion
Buddhism	Religion
Catholicism	Religion
Christian_Coalition_of_America	Religion
Christian_Science	Religion
Christianity	Religion
Anti-Christian_sentiment	Religion
Conservative_Judaism	Religion
Criticism_of_Conservative_Judaism	Religion
Creationism	Religion
Cult	Religion
Deism	Religion
Dhimmi	Religion
Divorce	Religion
Dorje_Shugden	Religion
Dorje_Shugden_controversy	Religion
Druze	Religion
Eastern_Orthodox_Church	Religion
Eckankar	Religion
Evangelicalism	Religion
Falun_Gong	Religion
Fundamentalism	Religion
Gnosticism_and_the_New_Testament	Religion
God	Religion
Gospel_for_Asia	Religion
Guru	Religion
Hare_Krishna	Religion
Hate_group	Religion
Historicity_of_Jesus	Religion
Homosexuality	Religion|||Sexuality
Iglesia_ni_Cristo	Religion
Imperium_(Warhammer_40,000)	Religion
Islamophobia	Religion
Islam	Religion
Jainism	Religion
Jehovah's_Witnesses	Religion
Jesus_freak	Religion
Judas_Iscariot	Religion
Kabbalah	Religion
Kashrut	Religion
Kosher_foods	Religion
Kokuch?kai	Religion
Ku_Klux_Klan	Religion
Last_Supper	Religion
Liturgy	Religion
Lutheranism	Religion
Mecca	Religion
Menachem_Mendel_Schneerson	Religion
Mennonite	Religion
Amish	Religion
Mormonism	Religion
Latter_Day_Saint_movement	Religion
Neocatechumenal_Way	Religion
New_Age	Religion
New_Kadampa_Tradition	Religion
Non-denominational	Religion
Ole_Nydahl	Religion
Diamond_Way_Buddhism	Religion
Opus_Dei	Religion
Pacifism	Religion
Paganism	Religion
Pentecostalism	Religion
Politics	Religion
Prem_Rawat	Religion
Divine_Light_Mission	Religion
Project_Chanology	Religion
Protestant_Reformation	Religion
Reincarnation	Religion
Republican_Party_(United_States)	Religion
Religious_right	Religion
Religion_and_sexuality	Religion
Role_of_women_in_religion	Religion
Feminist_theology	Religion
Separation_of_church_and_state	Religion
Satanism	Religion
Sathya_Sai_Baba	Religion
Seventh-day_Adventist_Church	Religion
Sin	Religion
Soka_Gakkai	Religion
Sufism	Religion
Syncretism	Religion
Taboo	Religion
Temple_Mount	Religion
United_Submitters_International	Religion
Quranism	Religion
Rashad_Khalifa	Religion
Universal_Life_Church	Religion
Universalism	Religion
Westboro_Baptist_Church	Religion
Abortion	Science, biology, and health
Attention_deficit_hyperactivity_disorder	Science, biology, and health
HIV/AIDS	Science, biology, and health|||People
HIV/AIDS_denialism	Science, biology, and health
Alcoholism	Science, biology, and health
Allergy	Science, biology, and health
Allopathic_medicine	Science, biology, and health
Alzheimer's_disease	Science, biology, and health
Alternative_medicine	Science, biology, and health
Anencephaly	Science, biology, and health
Anthropology	Science, biology, and health
Assisted_suicide	Science, biology, and health
Aspartame	Science, biology, and health
Aspartame_controversy	Science, biology, and health
Asperger_syndrome	Science, biology, and health
Autism	Science, biology, and health|||People
Astrology	Science, biology, and health
Bates_method	Science, biology, and health
Bioethics	Science, biology, and health
Biology_and_sexual_orientation	Science, biology, and health
Congenital_disorder	Science, biology, and health
Black_hole_information_paradox	Science, biology, and health
Blood_transfusion	Science, biology, and health
Cancer	Science, biology, and health
Caesarean_section	Science, biology, and health
Chakra	Science, biology, and health
Chiropractic	Science, biology, and health
Chromosome	Science, biology, and health
Circumcision	Science, biology, and health|||Sexuality
Cloning	Science, biology, and health
Cochlear_implant	Science, biology, and health
Cold_fusion	Science, biology, and health
Conjoined_twins	Science, biology, and health
Cryonics	Science, biology, and health
Depleted_uranium	Science, biology, and health
Major_depressive_disorder	Science, biology, and health
Disability	Science, biology, and health
Drug	Science, biology, and health|||People
Dyslexia	Science, biology, and health
Ebola_virus_disease	Science, biology, and health
Albert_Einstein	Science, biology, and health
Electromagnetic_hypersensitivity	Science, biology, and health
Eugenics	Science, biology, and health
Euthanasia	Science, biology, and health
Evolution	Science, biology, and health
Extraterrestrial_life	Science, biology, and health
Family_planning	Science, biology, and health
Female_genital_mutilation	Science, biology, and health
Modern_flat_Earth_societies	Science, biology, and health
Genetic_engineering	Science, biology, and health
Genetically_modified_food	Science, biology, and health
Gender	Science, biology, and health
Glyphosate	Science, biology, and health
Romani_people	Science, biology, and health|||People
Heredity	Science, biology, and health
Heritability_of_IQ	Science, biology, and health
High_fructose_corn_syrup	Science, biology, and health
HIV	Science, biology, and health
Health_maintenance_organization	Science, biology, and health
Hodgkin's_lymphoma	Science, biology, and health
Homeopathy	Science, biology, and health
Human_cloning	Science, biology, and health
Human_evolution	Science, biology, and health
Longevity	Science, biology, and health
Huntington's_disease	Science, biology, and health
Influenza	Science, biology, and health
Bird_flu	Science, biology, and health
Intelligent_design	Science, biology, and health
IQ_and_the_Wealth_of_Nations	Science, biology, and health
Kegel_exercise	Science, biology, and health
Kombucha	Science, biology, and health
Lactose_intolerance	Science, biology, and health
Life_extension	Science, biology, and health
Systemic_lupus_erythematosus	Science, biology, and health
Master_race	Science, biology, and health
Mental_disorder	Science, biology, and health
Intellectual_disability	Science, biology, and health
Michio_Kaku	Science, biology, and health
Mind_control	Science, biology, and health
MS	Science, biology, and health
Chronic_cerebrospinal_venous_insufficiency	Science, biology, and health
Mucoid_plaque	Science, biology, and health
Nutrition	Science, biology, and health
Obesity	Science, biology, and health
Organ_donation	Science, biology, and health
Organ_transplantation	Science, biology, and health
Overpopulation	Science, biology, and health|||Environment
DNA_paternity_testing	Science, biology, and health
Pharmaceutical_industry	Science, biology, and health
Pluto	Science, biology, and health
IAU_definition_of_planet	Science, biology, and health
Poppers	Science, biology, and health
Alkyl_nitrites	Science, biology, and health
Preterm_birth	Science, biology, and health
Prenatal_care	Science, biology, and health
Psychiatry	Science, biology, and health
Race_and_intelligence	Science, biology, and health
Recapitulation_theory	Science, biology, and health
Rh_blood_group_system	Science, biology, and health
Blood_type	Science, biology, and health
Schizophrenia	Science, biology, and health
Self-harm	Science, biology, and health
Sex_differences_in_intelligence	Science, biology, and health
Sex_differences_in_psychology	Science, biology, and health
Shiba_Inu	Science, biology, and health
Sexually_transmitted_infection	Science, biology, and health
Smoking	Science, biology, and health
Tobacco	Science, biology, and health
List_of_smoking_bans	Science, biology, and health
Sperm_donation	Science, biology, and health
Egg_donation	Science, biology, and health
Subluxation	Science, biology, and health
Surrogacy	Science, biology, and health
Tay-Sachs_disease	Science, biology, and health
Nikola_Tesla	Science, biology, and health|||People
In_vitro_fertilisation	Science, biology, and health
Therapeutic_touch	Science, biology, and health
Thiomersal	Science, biology, and health
Transgender	Science, biology, and health
Transsexual	Science, biology, and health|||Sexuality
Twin_paradox	Science, biology, and health
Universe	Science, biology, and health
Big_Bang	Science, biology, and health
Vaccine_controversies	Science, biology, and health
Veganism	Science, biology, and health
Vegetarianism	Science, biology, and health
Pregnancy	Science, biology, and health
Menopause	Science, biology, and health
Breast_cancer	Science, biology, and health
Ovarian_cancer	Science, biology, and health
69_(sex_position)	Sexuality
Sexuality_of_Abraham_Lincoln	Sexuality
Adultery	Sexuality
Age_of_consent	Sexuality
Child_grooming	Sexuality
Asian_fetish	Sexuality
Racial_fetishism	Sexuality
Attraction_to_disability	Sexuality
Abasiophilia	Sexuality
Erotic_asphyxiation	Sexuality
Blanchard's_transsexualism_typology	Sexuality
BDSM	Sexuality
Child_sexuality	Sexuality
Conversion_therapy	Sexuality
Ejaculation	Sexuality
Fetishism	Sexuality
Fingering_(sexual_act)	Sexuality
Fisting	Sexuality
Fornication	Sexuality
G-spot	Sexuality
Genetic_sexual_attraction	Sexuality
Gerontophilia	Sexuality
Hentai	Sexuality|||Media and culture
Hebephilia	Sexuality
Incest	Sexuality
Lolicon	Sexuality
Masturbation	Sexuality
Necrophilia	Sexuality
North_American_Man/Boy_Love_Association	Sexuality
Oral_sex	Sexuality
Orgasm	Sexuality
Paraphilia	Sexuality
Pederasty	Sexuality
Pedophilia	Sexuality
Polyamory	Sexuality
Polygamy	Sexuality
Pornography	Sexuality
Pregnancy_fetishism	Sexuality
Prostitution	Sexuality
Rape	Sexuality
Sadomasochism	Sexuality
Semen	Sexuality
Sex_offender	Sexuality
Sexual_abuse	Sexuality
Stalking	Sexuality
Swing	Sexuality
Swinging_(sexual_practice)	Sexuality
Zoophilia	Sexuality
Bumfights	Entertainment
WorldStarHipHop	Entertainment
Disc_jockey	Entertainment
Duke_Nukem_Forever	Entertainment
Development_hell	Entertainment
Entertainment_Software_Rating_Board	Entertainment
Gambling	Entertainment|||People
Girls_Gone_Wild_(franchise)	Entertainment
Hip_hop	Entertainment|||Media and culture
Hip_hop_music	Entertainment
Rapping	Entertainment|||Media and culture
List_of_best-selling_albums	Entertainment
Motion_Picture_Association_of_America_film_rating_system	Entertainment
Playboy	Entertainment
Pop_punk	Entertainment
Pornographic_magazine	Entertainment
Hustler	Entertainment
Penthouse	Entertainment
SeaWorld	Entertainment
Smooth_jazz	Entertainment|||Media and culture
Strip_club	Entertainment
Video_game_controversies	Entertainment
Psychedelic_trance	Entertainment
Hurricane_Katrina	Environment
New_Orleans	Environment
Deforestation	Environment
Logging	Environment
Dust_Bowl	Environment
Intensive_farming	Environment
Ecofascism	Environment
Eco-terrorism	Environment
Energy_consumption	Environment
Environmental_impact_of_hydraulic_fracturing	Environment
Environmental_vegetarianism	Environment
Fossil_fuel	Environment
Air_pollution	Environment
Greenhouse_gas	Environment
Natural_gas	Environment
Coal	Environment
Coal_mining	Environment
Gasoline	Environment
Oil_spill	Environment
Environmental_impact_of_the_oil_shale_industry	Environment
Global_warming	Environment
Global_cooling	Environment
Hydraulic_fracturing	Environment
Hydraulic_fracturing_in_the_United_States	Environment
Hydraulic_fracturing_by_country	Environment
Thermonuclear_weapon	Environment
Nuclear_weapon	Environment
An_Inconvenient_Truth	Environment
Mercury_poisoning	Environment
Minamata_disease	Environment
Mining	Environment
Deep_sea_mining	Environment
Nuclear_power	Environment|||Technology
Wind_farm	Environment
Oil_well	Environment
Arctic_National_Wildlife_Refuge	Environment
Alaska	Environment
Alaska_North_Slope	Environment
Population_growth	Environment
Ozone_depletion	Environment
Pollution	Environment
Recycling	Environment
Sea_level_rise	Environment
Three_Gorges_Dam	Environment
Hydroelectricity	Environment
Water_scarcity	Environment
Drought	Environment
Flood	Environment
Toxic_waste	Environment
Love_Canal	Environment
Weather_modification	Environment
Crime	Law and order
Double_jeopardy	Law and order
Prohibition_of_drugs	Law and order
Judiciary	Law and order
Jury_duty	Law and order
Law_enforcement	Law and order
Minor_(law)	Law and order
Juvenile	Law and order
Adolescence	Law and order
Prison	Law and order
Selective_Service_System	Law and order
Conscription	Law and order
Tax	Law and order
Internal_Revenue_Service	Law and order
Afrikaans	Linguistics
Afrikaner	Linguistics
South_Africa	Linguistics
Ancient_Macedonian_language	Linguistics
Balto-Slavic_languages	Linguistics
Basque_language	Linguistics
Official_bilingualism_in_Canada	Linguistics
Celtic_Revival	Linguistics
Celtic_languages	Linguistics
Cornwall	Linguistics
Brittany	Linguistics
Chinese_language	Linguistics
Creole_language	Linguistics
Den?-Caucasian_languages	Linguistics
Ebonics_(word)	Linguistics
Filipino_language	Linguistics
Tagalog_language	Linguistics
French_language_in_Canada	Linguistics
Graeco-Armenian	Linguistics
Discrimination	Linguistics
Indo-European_languages	Linguistics
Japanese_language	Linguistics
Korean_language	Linguistics
Ladin_language	Linguistics
Language_revitalization	Linguistics
Linguistics	Linguistics
Macedonian_language	Linguistics
Norwegian_language	Linguistics
Occitan_language	Linguistics
Occitania	Linguistics
Vergonha	Linguistics
Language_death	Linguistics
List_of_English-based_pidgins	Linguistics
Bokm?l	Linguistics
Linguistic_relativity	Linguistics
Sami_languages	Linguistics
Sami_people	Linguistics
Spanish_language_in_the_United_States	Linguistics
Turanism	Linguistics
Turkic_languages	Linguistics
Welsh_language	Linguistics
Yiddish_language	Linguistics
Friedrich_Nietzsche	Philosophy
Meaning_of_life	Philosophy
Plato	Philosophy
Scientific_method	Philosophy
Socrates	Philosophy
Truth	Philosophy
Sigmund_Freud	Psychiatry
Carl_Jung	Psychiatry
Phil_McGraw	Psychiatry
Thomas_Szasz	Psychiatry
BitTorrent	Technology
Blu-ray	Technology
Criticism_of_Microsoft	Technology
Criticism_of_Windows_Vista	Technology
Criticism_of_Apple_Inc.	Technology
Console_war	Technology
Cyberstalking	Technology
Digital_rights_management	Technology
Electric_car	Technology
Electronic_voting	Technology
Facebook	Technology|||Media and culture
Intensive_animal_farming	Technology
File_sharing	Technology
GNU/Linux_naming_controversy	Technology
Linux	Technology
Han_unification	Technology
HD_DVD	Technology
Indent_style	Technology
Myspace	Technology
Napster	Technology
Net_neutrality	Technology
Norton_AntiVirus	Technology
Object-oriented_programming	Technology
Peer-to-peer_file_sharing	Technology
Removal_of_Internet_Explorer	Technology
Smart_meter	Technology
Solar_power	Technology
Standardization_of_Office_Open_XML	Technology
The_Pirate_Bay	Technology
Unmanned_combat_aerial_vehicle	Technology
Windows_Vista	Technology
Anime	Media and culture
Beavis_and_Butt-head	Media and culture
BET	Media and culture
Closed-circuit_television	Media and culture
News_broadcasting	Media and culture
CNN	Media and culture
MSNBC	Media and culture
BBC	Media and culture
RT	Media and culture
Al_Jazeera	Media and culture
Censorship	Media and culture
Television_in_China	Media and culture
Digimon	Media and culture
Pok?mon	Media and culture
Digital_television	Media and culture
Disco	Media and culture
Drawn_Together	Media and culture
Emo	Media and culture
Culture_of_Europe	Media and culture
Family_Guy	Media and culture
Federal_Communications_Commission	Media and culture
Gamergate_controversy	Media and culture
LGBT_culture	Media and culture
Google	Media and culture
Goth_subculture	Media and culture
Harry_Potter	Media and culture
Hard_rock	Media and culture
Heavy_metal_music	Media and culture
Hippie	Media and culture
Internet_forum	Media and culture
Media_bias	Media and culture
Mad_TV	Media and culture
MTV	Media and culture
My_Little_Pony:_Friendship_Is_Magic	Media and culture
Etiquette_in_technology	Media and culture
Pentagon_Papers	Media and culture
The_New_York_Times	Media and culture
Punk_rock	Media and culture
Rave	Media and culture
Sacha_Baron_Cohen	Media and culture
Ali_G	Media and culture
Borat	Media and culture
Br?no	Media and culture
Saturday_Night_Live	Media and culture
The_Simpsons	Media and culture
Sirius_XM_Holdings	Media and culture
South_Park	Media and culture
Star_Trek	Media and culture
Star_Wars	Media and culture
Telemundo	Media and culture
Univision	Media and culture
Talk_radio	Media and culture
Freedom_of_speech	Media and culture
Time_Warner	Media and culture
Viacom	Media and culture
Trinity_Broadcasting_Network	Media and culture
Televangelism	Media and culture
The_Twilight_Saga	Media and culture
Twitter	Media and culture
Americana	Media and culture
Virgin_Records	Media and culture
Lifetime	Media and culture
Oxygen	Media and culture
We_(disambiguation)	Media and culture
World_Wide_Web	Media and culture
Internet	Media and culture
YouTube	Media and culture
Yuppie	Media and culture
Nero	People
Caligula	People
Mahmoud_Ahmadinejad	People
Syed_Ahmed	People
Muhammad_Ali	People
Kirstie_Alley	People
Idi_Amin	People
Criss_Angel	People
Yasser_Arafat	People
Murder_of_Travis_Alexander	People
Joe_Arpaio	People
Maricopa_County,_Arizona	People
Julian_Assange	People
Hans_Asperger	People
Mustafa_Kemal_Atat?rk	People
Gilad_Atzmon	People
Michelle_Bachelet	People
Michele_Bachmann	People
Brigitte_Bardot	People
Roseanne_Barr	People
Glenn_Beck	People
David_Beckham	People
Joy_Behar	People
Silvio_Berlusconi	People
Art_Bell	People
Conspiracy_theory	People
Bruno_Bettelheim	People
Joe_Biden	People
Tony_Blair	People
Robert_Blake_(actor)	People
Hans_Blix	People
Barry_Bonds	People|||Sports
Bay_Area_Laboratory_Co-operative	People
Major_League_Baseball	People|||Sports
Jose_Canseco	People
Mark_McGwire	People|||Sports
Alex_Rodriguez	People
Bonnie_and_Clyde	People
Roger_Joseph_Boscovich	People
John_and_Lorena_Bobbitt	People
Marital_rape	People
Leonid_Brezhnev	People
Jerry_Brown	People
Murphy_Brown	People
Anita_Bryant	People
Kobe_Bryant	People
Pat_Buchanan	People
Ted_Bundy	People
George_W._Bush	People
George_H._W._Bush	People
Jeb_Bush	People
Richard_Girnt_Butler	People
Aryan_Nations	People
George_Carlin	People
Jimmy_Carter	People
Fidel_Castro	People
Ra?l_Castro	People
Cesar_Chavez	People
Hugo_Ch?vez	People
Dave_Chappelle	People
Dick_Cheney	People
Halliburton	People
Cher	People
Sonny_Bono	People
Mary_Bono	People
Jacques_Chirac	People
Margaret_Cho	People
Seung-Hui_Cho	People
Virginia_Tech	People
Chris_Christie	People
Ward_Churchill	People
Bill_Clinton	People
Hillary_Clinton	People
Walmart	People
Kurt_Cobain	People
Christopher_Columbus	People
Sean_Combs	People
Nicolaus_Copernicus	People
Stephen_Colbert	People
Jon_Corzine	People
Ann_Coulter	People
Tom_Cruise	People
Miley_Cyrus	People
Salvador_Dal?	People
Jeffrey_Dahmer	People
Angela_Davis	People
Richard_Dawkins	People
Ellen_DeGeneres	People
Paula_Deen	People
Hassan_Diab	People
1980_Paris_synagogue_bombing	People
Andrew_Dice_Clay	People
Dixie_Chicks	People
Walt_Disney	People
Phil_Donahue	People
David_Duke	People
Andrea_Dworkin	People
John_Edwards	People
Marc_Emery	People
Eminem	People
Pablo_Escobar	People
Jerry_Falwell	People
Melissa_Farley	People
Gerald_Ford	People
Henry_Ford	People
Michael_J._Fox	People
Christopher_Reeve	People
Al_Franken	People
Kenny_G	People
Muammar_Gaddafi	People
William_Gaillard	People
Galileo_Galilei	People
Janeane_Garofalo	People
Charles_de_Gaulle	People
Mel_Gibson	People
Homophobia	People
Kathie_Lee_Gifford	People
Sweatshop	People
Frank_Gifford	People
Comedy	People
Newt_Gingrich	People
Girls_Aloud	People
Rudy_Giuliani	People
Nancy_Grace	People
Wayne_Gretzky	People
Janet_Jones	People
Joseph_Goebbels	People
Whoopi_Goldberg	People
The_View_(U.S._TV_series)	People
Barry_Goldwater	People
Mikhail_Gorbachev	People
Al_Gore	People
Temple_Grandin	People
Alan_Greenspan	People
Woody_Guthrie	People
Guns_N'_Roses	People
Axl_Rose	People
Ferenc_Gyurcs?ny	People
Ted_Haggard	People
Tarja_Halonen	People
Ken_Ham	People
Young_Earth_creationism	People
Sean_Hannity	People
Phil_Hendrie	People
Patty_Hearst	People
Symbionese_Liberation_Army	People
Hideki_Tojo	People
Paris_Hilton	People
Anita_Hill	People
Clarence_Thomas	People
Heinrich_Himmler	People
Hirohito	People
Slavs	People
Erich_Honecker	People
Jimmy_Hoffa	People
Kidnapping	People
J._Edgar_Hoover	People
Katie_Hopkins	People
John_Howard	People
L._Ron_Hubbard	People
Mike_Huckabee	People
Rock_Hudson	People
Saddam_Hussein	People
Cat_Stevens	People
Andrew_Jackson	People
George_Jackson_(Black_Panther)	People
Jesse_Jackson	People
Michael_Jackson	People
Trial_of_Michael_Jackson	People
Jay_Z	People
Beyonc?	People
Thomas_Jefferson	People
Sheila_Jeffreys	People
Elton_John	People
Magic_Johnson	People
Angelina_Jolie	People
Brad_Pitt	People
Alex_Jones	People
Jenny_Jones	People
Michael_Jordan	People
John_F._Kennedy	People
Robert_F._Kennedy	People
Ted_Kennedy	People
Jacqueline_Kennedy_Onassis	People
Kim_Kardashian	People
Andy_Kaufman	People
Ruhollah_Khomeini	People
Nikita_Khrushchev	People
Kim_Il-sung	People
Kim_Jong-il	People
Kim_Jong-un	People
Martin_Luther_King,_Jr.	People
Rodney_King	People
Pia_Kj?rsgaard	People
Philip_J._Klass	People
Murder_of_Polly_Klaas	People
Shosei_Koda	People
Junichir?_Koizumi	People
Chris_Kyle	People
United_States_Navy_SEALs	People
K.d._lang	People
Ricki_Lake	People
Lyndon_LaRouche	People
Carlos_Latuff	People
Norman_Lear	People
Jean-Marie_Le_Pen	People
Heath_Ledger	People
Vladimir_Lenin	People
John_Lennon	People
Scooter_Libby	People
G._Gordon_Liddy	People
Lil_Wayne	People
Rush_Limbaugh	People
Abraham_Lincoln	People
Habeas_corpus	People
Jennifer_Lopez	People
Lil_B	People
Trent_Lott	People
Courtney_Love	People
Martin_Luther	People
Catharine_MacKinnon	People
Madonna_(entertainer)	People
Bernard_Madoff	People
John_Major	People
Nelson_Mandela	People
Winnie_Madikizela-Mandela	People
Charles_Manson	People
Marilyn_Manson	People
Mao_Zedong	People
Ferdinand_Marcos	People
Imelda_Marcos	People
Rachel_Marsden	People
Karl_Marx	People
Jackie_Mason	People
John_Mayer	People
John_McCain	People
Paul_McCartney	People
Jenny_McCarthy	People
Steve_McNair	People
Timothy_McVeigh	People
Dmitry_Medvedev	People
Golda_Meir	People
Carlos_Mencia	People
Angela_Merkel	People
Freddie_Mercury	People
Harvey_Milk	People
Kenji_Miyazawa	People
Demi_Moore	People
Ashton_Kutcher	People
Michael_Moore	People
Jim_Morrison	People
Mother_Teresa	People
Benito_Mussolini	People
Napoleon	People
Snooki	People
Jersey_Shore	People
Stereotype	People
Wikipedia:Citation_needed	People
Olivia_Newton-John	People
Richard_Nixon	People
The_Notorious_B.I.G.	People
Rosie_O'Donnell	People
Gregg_Hughes	People
Anthony_Cumia	People
Opie_and_Anthony	People
Bill_O'Reilly_(political_commentator)	People
Barack_Obama	People
Keith_Olbermann	People
Ozzy_Osbourne	People
Donny_Osmond	People
Marie_Osmond	People
Mormons	People
Terrell_Owens	People
Sarah_Palin	People
Nancy_Pelosi	People
Juan_Per?n	People
Eva_Per?n	People
Scott_Peterson	People
Augusto_Pinochet	People
Valerie_Plame	People
Pope_Benedict_XIV	People
Pope_John_Paul_II	People
Pope_Pius_XII	People
Elvis_Presley	People
Prince	People
Charles,_Prince_of_Wales	People
Diana,_Princess_of_Wales	People
Camilla,_Duchess_of_Cornwall	People
Prince_Harry	People
Prince_William,_Duke_of_Cambridge	People
Catherine,_Duchess_of_Cambridge	People
Pol_Pot	People
Vladimir_Putin	People
Richard_Ramirez	People
Murder_of_JonBen?t_Ramsey	People
Ronald_Reagan	People
Janet_Reno	People
Condoleezza_Rice	People
Michael_Richards	People
Laugh_Factory	People
Yvonne_Ridley	People
Alberto_Rivera	People
Geraldo_Rivera	People
Michael_Roach	People
Oral_Roberts	People
Pat_Robertson	People
John_Rocker	People
Sports_Illustrated	People
Kid_Rock	People
Rom?rio	People
Mitt_Romney	People
Linda_Ronstadt	People
Franklin_D._Roosevelt	People
Theodore_Roosevelt	People
Ben_Roethlisberger	People
Pete_Rose	People|||Sports
Karl_Rove	People
Babe_Ruth	People
Donald_Rumsfeld	People
Bobby_Sands	People
Nicolas_Sarkozy	People
Michael_Savage	People
Terri_Schiavo_case	People
Gerhard_Schr?der	People
Arnold_Schwarzenegger	People
California	People
Mita_Congregation	People
Selena	People
William_Shakespeare	People
Shakespeare_authorship_question	People
Tupac_Shakur	People
Al_Sharpton	People
Charlie_Sheen	People
Matthew_Shepard	People
Sherlock_Holmes	People
The_Sifl_and_Olly_Show	People
O._J._Simpson	People
Anna_Nicole_Smith	People
Joseph_Smith	People
The_Church_of_Jesus_Christ_of_Latter-day_Saints	People
Edward_Snowden	People
Eddie_?Piol?n?_Sotelo	People
Sonia_Sotomayor	People
Snoop_Dogg	People
Britney_Spears	People
Kevin_Federline	People
Spice_Girls	People
Jerry_Springer	People
Joseph_Stalin	People
Gloria_Steinem	People
Erika_Steinbach	People
Howard_Stern	People
Shock_jock	People
Jon_Stewart	People
Sting	People
John_Stossel	People
Barbra_Streisand	People
Jimmy_Swaggart	People
Tim_Tebow	People
Serbs	People
Croats	People
Margaret_Thatcher	People
Pierre_Trudeau	People
Harry_S._Truman	People
Donald_Trump	People
Ted_Turner	People
Mike_Tyson	People
U2	People
Joran_van_der_Sloot	People
Michael_Vick	People
Varg_Vikernes	People
Barbara_Walters	People
John_Walsh	People
Murder_of_Adam_Walsh	People
Andy_Warhol	People
Kanye_West	People
Ruth_Westheimer	People
Joseph_C._Wilson	People
Woodrow_Wilson	People
Oprah_Winfrey	People
Tiger_Woods	People
Malcolm_X	People
Andrea_Yates	People
Postpartum_depression	People
Boris_Yeltsin	People
Yoko_Ono	People
The_Beatles	People
Zinedine_Zidane	People
George_Zimmerman	People
Trayvon_Martin	People
Jacob_Zuma	People
1919_World_Series	Sports
Chicago_White_Sox	Sports
Cincinnati_Reds	Sports
Golf	Sports
College_football	Sports
Super_Bowl_XXXVIII	Sports
Alberta	Politics and economics